%s ago=%s sedan
%s used of %s %s %%=%s använt av %s (%s %%)
1 m=1 min
10 s=10 sek
2 m=2 min
30 s=30 sek
5 m=5 min
Abort background operation=Abryt bakgrunds operation 
Abort background process=Avbryt bakgrunds process
Active tunnels=Aktiva tunnlar
Activity=Aktivitet
ago=sedan
Airflow=Luftflöde
Alert Message=Varnings Meddelande
Alerts=Varningar
All Apps=Alla Appar
All VMs=Alla VMer
Array Information=Array Information
Attention - operation continues in background=Uppmärksamma - drift fortsätter i bakgrunden
Battery charge=Batteriladdning
BIOS dated=BIOS daterat
Check free space=Kontrollera ledigt utrymme
Click to toggle CPU chart=Klicka för att växla CPU-diagram
Click to toggle details=Klicka för att växla detaljer
Clock is unsynchronized with no NTP servers=Klockan är osynkroniserad utan NTP-servrar
Clock synchronized with %s NTP server=Klockan är synkroniserad med %s NTP-server
Clock synchronized with %s NTP servers=Klockan är synkroniserad med %s NTP-servrar
Clone=Klon
Close Tile=Stäng panel
Completed=Färdigställd
Containers=Behållare
Content Management=Innehållshantering
Counters info=Räknarinfo
Current operation %s on %s=Aktuell process %s på **%s**
custom image=anpassad avbild
Data is invalid=Data är ogiltig
default image=standard avbild
Docker Containers=Docker Behållare
Docker folder=Docker-mapp
Docker vdisk=Docker vdisk
Due in=Färdig om
Edit VM after clone=Redigera VM efter klon
Elapsed time=Förfluten tid
Errors info=Felinfo
Estimated finish=Beräknat färdig
failed device=fel på enhet
Fan count=Antal fläktar
Fan Information=Fläkt Information
FAN=Fläkt
Finding %s error=Hittar: **%s** fel
Finding %s errors=Hittar: **%s** fel
Flash device=Flash enhet
Free=Ledigt
General info=Generell info
Go to CPU pinning settings=Gå till CPU-pinningsinställningar
Go to date and time settings=Gå till Tid & Datum inställningar
Go to disk settings=Gå till diskinställningar
Go to Docker settings=Gå till Docker-inställningar
Go to fan settings=Gå till fläktinställlningar
Go to identification settings=Gå till identifikationsinställningar
Go to network settings=Gå till nätverksinställningar
Go to scheduler settings=Gå till schemainställningar
Go to Share settings=Gå till delningsinställningar
Go to UPS settings=Gå till UPS-inställningar
Go to User settings=Gå till användarinställningar
Go to VM settings=Gå till VM-inställningar
Go to VPN settings=Gå till VPN-inställningar
Handshake=Handskakning
has=har
healthy=frisk
heat warning=temperatur varning
Hide details=Göm detaljer
in progress=pågående
Inactive tunnels=Inaktiva tunnlar
inactive=inaktiv
Inbound=Inkommande
Information=Information
Interface Information=Gränssnittsinformation
invalid device=Ogiltig enhet
invalid devices=Ogiltiga enheter
Last check completed on %s=Senaste kontroll slutförd den **%s**
Last check incomplete on %s=Senaste kontroll slutfördes inte den **%s**
Last checked on %s=Senast kontrollerad **%s**
Legend=Legend
Lock sortable items=Lås sorterbara objekt
Log filesystem=Logga filsystem
Maximum size=Maximal storlek
Memory Utilization=Minnesanvändning
Mode of operation=Driftsätt
Motherboard Information=Information om Moderkort
Network traffic=Nätverkstrafik
New VM=Ny VM
Next check scheduled on %s=Nästa schemalagda kontroll den **%s**
No docker containers defined=Inga docker behållare definierade
No running docker containers=Inga aktiva docker behållare
No running virtual machines=Inga aktiva virtuella maskiner
No shares present=Inga delningar närvarande
No virtual machines defined=Inga virtuella maskiner definierade
Nominal power=Nominell effekt
not received=inte mottagen
Notices=Meddelanden
Notifications=Notifikationer
Only PNG images are allowed=Only PNG images are allowed!
Outbound=Utgående
Output voltage=Utspänning
Overall Load=Total last
Overwrite=Skriv över
Parity disk not present=Paritetsdisk saknas
Parity disks not present=Paritetsdiskar saknas
Parity has not been checked yet=Paritet har inte kontrollerats
Parity Information=Paritetsinformation
Parity is degraded=Paritet är degraderad
Percent of total used memory=Procent utav totalt använt minne
Percent usage of Docker folder=Procentuell användning av Docker-mappen
Percent usage of Docker vdisk=Procentuell användning av Docker vdisk
Percent usage of flash usb device=Procentuell användning av flash usb enhet
Percent usage of LOG file system=Procentuell användning av LOG-filsystemet
Pool=Pool
Power Status=Strömstatus
Power=Ström
Processor Information=Processorinformation
Put system to sleep=Försätt systemet i viloläge
RAM usage=Minnes användning
Reboot the system=Starta om systemet
Receive counters=Mottagningsräknare
Received packets=Mottagna paket
Runtime left=Körtid kvar
Scheduled parity check is disabled=Schemalagd paritetskontroll är inaktiverad
Select Case Model=Välj chassimodell
Select time frame=Välj tidsram
Services=Tjänster
Share count %s with %s cache only and %s encrypted=Antal andelar: %s med endast %s cache och %s krypterad
Shares Information=Delningsinformation
Show details=Visa detaljer
Show Information=Visa information
ShowHide All Content=Visa/dölj allt innehåll
ShowHide Content=Visa/dölj innehåll
Shutdown the system=Stäng av systemet
SMART error=SMART-fel
SMART health-check failed=SMART statuskontroll misslyckades
SMART=SMART
sn=s/n
Snapshot Name=Snabbkopians namn
Snapshot=Snabbkopia
Start Cloned VM=Starta klonad VM
Start the array=Starta arrayen
Started only=Endast startade
Stop the array=Stoppa arrayen
Temp=Temperatur
This may leave an unknown state=Detta kan lämna ett okänt tillstånd
This will put the system to sleep=Detta kommer försätta systemet i viloläge
This will reboot the system=Detta kommer starta om systemet
This will shutdown the system=Detta kommmer stänga av systemet
This will start the array=Detta kommer starta arrayen
This will stop the array=Detta kommer stoppa arrayen
Tile Management=Panelhantering
Transmit counters=Överföringsräknare
Transmitted packets=Skickade paket
Unassigned Devices=Ej tilldelade enheter
Unlock sortable items=Lås upp sorterbara objekt
UPS Load=UPS-belastning
UPS Model=UPS-modell
UPS status=UPS-status
Usable size=Användbart utrymme
User count %s with %s unprotected=Användarantal %s med %s oskyddade
Users Information=Användarinformation
utilization warning=användningsvarning
View Running Processes=Visa aktiva processer
Virtual Machines=Virtuella Maskiner
VM Being Cloned=VM klonas
VM Clone=VM klon
VM Name=VM namn
VPN Connections=VPN-anslutningar
W=W
Warnings=Varningar
ZFS=ZFS

; Note: December 25, 2023 - 93 missing translations
