Access Mode=Åtkomstläge
Add another Path, Port, Variable, Label or Device=Lägg till en annan Sökväg, Port, Variabel, Etikett eller Enhet
Add Configuration=Lägg till konfiguration
Add=Lägg till
Additional Requirements=Ytterligare krav
Always=Alltid
App to Host=App till värd
Application=Applikation
apply update=tillämpa uppdatering
Are you sure=Är du säker
Array must be Started to view Docker containers=Arrayen måste vara startad för att se Docker-containrar
Autostart=Autostart
Back=Tillbaka
Backup=Säkerhetskopiera
Beta=Beta
Books=Böcker
By=Av
Categories=Kategorier
Check for Updates=Leta efter uppdateringar
Cloud=Moln
Config Type=Konfigurationstyp
Configuration not found=Konfiguration ej funnen
Connection Type=Anslutningstyp
Console shell command=Konsolkommandorad
Container ID=Container-ID
Container Path=Container-sökväg
Container Port=Container-port
Container Size=Container-storlek
Container=Container
CPU Memory load=CPU-minnes belastning
CPU Pinning=CPU-bindning
Created=Skapad
Crypto Currency=Kryptovaluta
Default Value=Standardvärde
Device=Enhet
Display=Display
DNS=DNS
Docker Containers=Docker-containrar
Docker Hub URL=Docker Hub-länk
Docker Service failed to start=Dockertjänsten kunde inte starta
Downloaders=Nedladdare
Drivers=Drivrutiner
Edit Configuration=Redigera konfiguration
Exited=Avslutad
Extra Parameters=Extra parametrar
Fixed IP address=Statisk IP-adress
force update=tvinga uppdatering
FTP=FTP
Game Servers=Spelservrar
healthy=frisk
Hide Buttons=Göm knappar
Hide docker allocations=Dölj dockerallokeringar
Hide more settings=Dölj fler inställningar
Home Automation=Hemautomation
Host Path=Värdsökväg
Host Port=Värdport
HT=HT
Icon URL=Ikon-länk
Image ID=Avbilds-ID
Key=Nyckel
Label=Etikett
Lock sortable items=Lås sorteringsbara objekt
Management=Hantera
MediaApp=MediaApp
MediaServer=Mediaserver
Messenger=Meddelandetjänst
Missing parameters=Parameter saknas
Music=Musik
Network Type=Nätverkstyp
No Docker containers installed=Inga Docker-containrar installerade
None Listed=Ingen listad
of=av
orphan image=övergiven avbild
Other=Annat
Overview=Översikt
Path=Sökväg
Pause All=Pausa alla
Photos=Foton
Port Mappings=Portmappningar
Port=Port
Post Arguments=Post-argument
Privileged=Priviligerad
Productivity=Produktivitet
Project Page=Projektsida
Proxy=Proxy
Pulling image=Hämtar avbild
Read Me First=Läs mig först
Read Only - Shared=Läsbehörighet - Delad
Read Only - Slave=Läsbehörighet - Slav
Read Only=Läsbehörighet
ReadWrite - Shared=Läs-/Skrivbehörighet - Delad
ReadWrite - Slave=Läs-/Skrivbehörighet - Slav
rebuild ready=uppbyggning färdig
rebuilding=återuppbyggning
Remove template=Ta bort mall
Removing container=Tar bort container
Removing orphan image=Tar bort övergiven avbild
Repository=Repository
Required=Obligatorisk
Reset sorting=Återställ sortering
Resume All=Återuppta alla
Save=Spara
Select a template=Välj en mall
Select categories=Välj kategorier
Show docker allocations=Visa dockerallokeringar
Show more settings=Visa fler inställningar
Stable=Stabil
Start All=Starta alla
starting up containers=startar containrar
Stop All=Stoppa alla
Stopping container=Stoppar container
Successfully removed container=Container borttagning framgångsrik
Successfully removed orphan image=Borttagning utav övergiven avbild framgångsrik
Successfully stopped container=Container stoppad framgångsrikt
Support Thread=Supporttråd
Template URL=Mall-länk
Template=Mall
The command failed=Kommandot misslyckades
The command finished successfully=Kommandot kördes framgångsrikt
TOTAL DATA PULLED=TOTAL DATA HÄMTAD
Total size=Total storlek
Unknown action=Okänd åtgärd
Unlock sortable items=Frigör sorteringsbara objekt
Update All=Uppdatera alla
update ready=uppdatering redo
Value=Värde
Variable=Variabel
Video=Video
Voip=VoIP
Volume Mappings=Volymmappningar
wait=vänta
Was this container created using this plugin=Skapades den här containern med det här pluginet
Web=Webb
WebUI=WebUI
Writable=Skrivbar
