also remove image=ta även bort image
Apply=Verkställ
Are you sure=Är du säker?
Cancel=Avbryt
checking=kontrollerar
Completely REMOVE=Ta bort HELT
Console=Konsoll
day=dag
days=dagar
disk image and definition=diskavbildning och definition
Disks=Diskar
Done=Klar
Edit=Redigera
Execution error=Exekveringsfel
Force Stop=Tvinga stopp
Hibernate=Strömsparläge
Log for=Logg för
log=logg
Logs=Loggar
More Info=Mer info
No=Nej
OK=OKEJ
Ok=Okej
Pause=Paus
Proceed=Fortsätt
Project Page=Projektsida
Remove container=Ta bort container
Remove definition=Ta bort definition
Remove image=Ta bort avbild
Remove VM=Ta bort VM
Remove=Ta bort
Restart=Starta om
Resume=Återuppta
Start=Starta
Stop=Stoppa
Support=Support
Update container=Uppdatera container
Update=Uppdatera
Updating all Containers=Uppdaterar alla containrar
Updating the container=Uppdaterar containern
VNC Remote=VNC Fjärrstyrning
WebUI=Webbgränssnitt
Yes, delete it=Ja, ta bort den!
Yes, update it=Ja, uppdatera den!
Yes=Ja

; footer messages
Array Starting=Arrayen startar
Array Stopping=Arrayen stoppas
Mounting disks=Monterar diskar
Spinning up all drives=Startar upp alla diskar
Starting services=Startar tjänster
Stopping services=Stoppar tjänster
Unmounting disks=Avmonterar diskar
Autostart disabled=Autostart inaktiverad
Missing encryption key=Saknar krypteringsnyckel
Opening encrypted volumes=Öppnar krypterade volymer

; docker variables

; Note: April 29, 2023 - 14 missing translations
Donate=Donera
Read Me First=Läs mig först
Array Copying=Arrayen kopierar
Array Clearing=Arrayrensning
Retry unmounting user shares=Retry unmounting user share(s)
Stale configuration=Inaktuell konfiguration
Starting Recycle Bin=Startar papperskorgen
Stopping Recycle Bin=Stoppar papperskorgen
Sync filesystems=Synka filsystemen
Container Path=Container-sökväg
Container Port=Container-port
Container Variable=Container-variabel
Container Label=Container-etikett
Container Device=Container-enhet
