

; Note: July 9, 2023 - 42 missing translations
%s An update is available=%s: En uppdatering är tillgänglig.
Alert Message=Varningsmeddelande
anonymous=Anonym
Author=Skapare
Check For Updates=Kontrollera uppdateringar
Checking connectivity=Kontrollerar anslutning
checking=kontrollerar
Click here to install version %s=Klicka här för att installera version %s
Delete Plugin=Ta bort plugin
DOWNGRADE TO VERSION=ÅTERGÅ TILL VERSION
Enter URL of remote plugin file or local plugin file=Ange länk för fjärrplugin-fil eller lokal plugin-fil
ERROR=FEL
I have read the release notes=Jag har läst versionsanteckningarna
Install Plugin=Installera plugin
Install=Installera
install=installera
Installed Plugins=Installerade plugins
Installing Update=Installerar uppdatering
need check=behöver kontroll
Next=Nästa
No plugins installed=Inga plugins installerade
No release notes available=Inga versionsanteckningar tillgängliga
No response, aborting=Ingen respons, avbryter
Plugin File Install Errors=Fel vid installation av plugin-fil
Plugin File=Plugin-fil
Plugin History=Plugin-historik
Plugin Update Check=Kontroll av plugin-uppdatering
Plugin=Plugin
Release Notes=Versionsanteckningar
Remove Plugin=Ta bort plugin
Remove Selected Plugins=Ta bort valda plugins
remove=ta bort
Select local plugin file=Välj lokal plugin-fil
Stable=Stabil
STALE=UTDATERT
Support Thread=Supporttråd
Uninstall=Avinstallera
Update All Plugins=Uppdatera alla plugins
Update Incompatible=Uppdatera inkompatibla
Update Plugin=Uppdatera plugin
Upgrade=Uppgradera
View Release Notes=Visa versionsanteckningar

