Add Share=Lägg till delning
All files encrypted=Alla filer är krypterade
All files protected=Alla filer är skyddade
All files unprotected=Alla filer är oskyddade
Allocation method=Tilldelningsmetod
Array must be Started to view Shares=Arrayen måste vara **startad** för att visa delningar
Automatically split any directory as required=Dela endast automatiskt upp: vilken som helst av mapparna/katalogerna vid behov
Automatically split only the top five directory levels as required=Dela endast automatiskt upp: de fem översta mapp-/katalognivåerna vid behov
Automatically split only the top four directory levels as required=Dela endast automatiskt upp: de fyra översta mapp-/katalognivåerna vid behov
Automatically split only the top level directory as required=Dela endast automatiskt upp: den översta mapp-/katalognivån vid behov
Automatically split only the top three directory levels as required=Dela endast automatiskt upp: de tre översta mapp-/katalognivåerna vid behov
Automatically split only the top two directory levels as required=Dela endast automatiskt upp: de två översta mapp-/katalognivåerna vid behov
Clean Up=Rensa
CLEAN UP=RENSA
Comments=Kommentarer
Compute All=Beräkna allt
Compute=Beräkna
Disk Shares=Diskdelningar
Do not use pool names=Använd inte poolnamn
Do not use reserved names=Använd inte reserverade namn
Enable Copy-on-write=Aktivera Copy-on-write
Enter a name for the share=Ange ett namn för delningen
Excluded disks=Exkluderade diskar
Exclusive access=Exklusiv åtkomst
Export=Exportera
Fill-up=Fyll upp
Free=Ledigt
has been deleted=har raderats
HDD=HDD
High-water=Datautjämning
Included disks=Inkluderade diskar
Invalid Characters=Ogiltiga tecken
Invalid share name=Ogiltigt delningsnamn
Manual do not automatically split directories=Manuell: dela inte upp kataloger automatiskt
Minimum free space=Minimalt ledigt utrymme
Missing share name=Saknar delningsnamn
Most-free=Med mest ledigt
Mover action=Mover-åtgärd
Mover takes no action=Mover vidtar ingen åtgärd
Mover transfers files from array to cache=Mover överför filer från arrayen till cache
Mover transfers files from cache to array=Mover överför filer från cache till arrayen
Mover transfers files from Primary storage to Secondary storage=Mover överför filer från primär lagring till sekundär lagring
Mover transfers files from Secondary storage to Primary storage=Mover överför filer från sekundär lagring till primär lagring
next user share=nästa användardelning
No unused share configurations present=Inga oanvända delningskonfigurationer finns
Not used=Ej använd
Only=Endast
Prefer=Föredra
previous user share=föregående användardelning
Primary storage %s=Primär lagring %s
Primary storage for new files and folders=Primär lagring (för nya filer och mappar)
Primary storage to Secondary storage=Primär lagring till sekundär lagring
Read=Läs
Recompute=Beräkna om
Remove unused share configurations=Ta bort oanvända delningskonfigurationer
Removed share configurations=Raderade delningskonfigurationer
Rule=Regel
Secondary storage to Primary storage=Sekundär lagring till primär lagring
Secondary storage=Sekundär lagring
Select cache pool=Välj cachepool
Set when adding new share only=Ställ endast in vid tillägg av ny delning
Share contains data=Delning innehåller data
Share is empty=Delningen är tom
Share is outside the list of designated disks=Delningen är utanför listan över angivna diskar
Share name contains invalid characters for ZFS use=Delningsnamn innehåller ogiltiga tecken för ZFS-användning
Share Settings=Delningsinställningar
Share status=Delningsstatus
Size=Storlek
Some or all files unencrypted=Vissa eller alla filer är okrypterade
Some or all files unprotected=Vissa eller alla filer är oskyddade
Split level=Splitternivå
SSD=SSD
Storage=Lagring
There are no exportable disk shares=Det finns inga exportabla diskdelningar
There are no exportable user shares=Det finns inga exportabla användardelningar
Time Machine volume size limit=Time Machine-volymstorleksgräns
Unknown encryption state=Okänt krypteringstillstånd
User Shares=Användardelningar
Write=Skriv
You cannot use the following within share names=Du kan inte använda följande inom delningsnamn

; Note: April 21, 2025 - 13 missing translations
Free Space will be calculated=
is missing=
it references storage that does not exist=
It references storage that does not exist=
Share is empty and is safe to delete=
Share must be empty to be deleted=
There are no mountable array or pool disks - cannot add shares=
There are no mounted array or pool disks - cannot add shares=
This share is invalid=
Unknown cache usage=
Unknown protection status=
Use cache pool for new filesdirectories=Use cache pool (for new files/directories)
Warning: Configured Pool=
